A	AH
A(2)	EY
B	B IY
BACKSPACE	B AE K S P EY S
C	S IY
D	D IY
E	IY
ENTER	EH N T ER
ENTER(2)	EH N ER
EXIT	EH G Z IH T
EXIT(2)	EH K S AH T
F	EH F
G	JH IY
H	EY CH
I	AY
J	JH EY
K	K EY
L	EH L
M	EH M
N	EH N
O	OW
P	P IY
Q	K Y UW
R	AA R
S	EH S
SHIFT	SH IH F T
SPACE	S P EY S
T	T IY
TAB	T AE B
U	Y UW
V	V IY
W	D AH B AH L Y UW
X	EH K S
Y	W AY
Z	Z IY
